NO ./textures/text1.xpm
SO ./textures/text2.xpm
WE ./textures/text3.xpm
EA ./textures/text4.xpm

F 220,100,0
C 225,30,0

1111111111
10000000E0
1111111111