SO ./textures/lake.xpm
EA ./textures/hanim_abla.xpm
NO ./textures/tree2.xpm
WE ./textures/tree.xpm
F 24,24,7
C 10,25,28

1111111111
1000000001
1000100001
1000000001
10000000E1
1000000001
1000000001
1000000111
1000000001
1111111111

